com.big_eyes.store
0 0
. . . . . . .
. p h . . . e
. . . . . . .
. . . . . . x
. . . . . . .
. . . . . . .
. e . x . . .