com.google
0 0
. . . . .
. . h . .
. . . . .
. . . . .
. x . x .
. . . . .