com.grate.zone
0 0
...s...p.....
..........b..
.............
h............
.............
.w...w...w..u