com.big_eyes.store
0 0
. . . . . . .
. p h . . . e
. . . . . . .
. . . . . . X
. . . . . . .
. . . . . . .
. e . x . . .