com.boss.api
3 0
h.p.y....
.b.......
s........
.........
.........
.......X.
.....X...
.f.m.m..z